# CVS $Revision: $ $Author: $ -- Thu Jul 10 13:59:32 2014 -- reformated by prettylst.pl v1.51 (build 24365)


# Deity Name		Domains
Abaddon			DOMAINS:Catastrophe,Chaos,Death,Evil|PREALIGN:CE,CN,NE
Abraxas			DOMAINS:Chaos,Evil,Knowledge,Magic,Protection|PREALIGN:CE,CN,NE
Anarazel			DOMAINS:Chaos,Earth,Evil,Fear|PREALIGN:CE,CN,NE
Arachnadia			DOMAINS:Chaos,Destruction,Evil,Trickery|PREALIGN:CE,CN,NE
Astaroth			DOMAINS:Chaos,Evil,Knowledge,Prophecy|PREALIGN:CE,CN,NE
Azazel			DOMAINS:Animal,Chaos,Disease,Evil|PREALIGN:CE,CN,NE
Azidahaka			DOMAINS:Chaos,Evil,Fear,Pain|PREALIGN:CE,CN,NE
Baphomet			DOMAINS:Chaos,Evil,Protection,Strength|PREALIGN:CE,CN,NE
Behemoth			DOMAINS:Animal,Chaos,Evil,Strength|PREALIGN:CE,CN,NE
Decarabia			DOMAINS:Air,Chaos,Evil,Subterfuge|PREALIGN:CE,CN,NE
Demogorgon			DOMAINS:Chaos,Evil,Fear,Pain|PREALIGN:CE,CN,NE
Eligor			DOMAINS:Chaos,Evil,Knowledge,War|PREALIGN:CE,CN,NE
Flauros			DOMAINS:Chaos,Evil,Fire,Sun|PREALIGN:CE,CN,NE
Gamigin			DOMAINS:Chaos,Death,Evil,Knowledge|PREALIGN:CE,CN,NE
Haagenti			DOMAINS:Change,Chaos,Earth,Evil|PREALIGN:CE,CN,NE
Ipos				DOMAINS:Chaos,Eloquence,Evil,Trickery|PREALIGN:CE,CN,NE
Kostchtchie			DOMAINS:Chaos,Crippling,Evil,Strength|PREALIGN:CE,CN,NE
Lord of Many Forms	DOMAINS:Change,Chaos,Evil,Pain|PREALIGN:CE,CN,NE
Marbas			DOMAINS:Change,Chaos,Disease,Evil|PREALIGN:CE,CN,NE
Orcus				DOMAINS:Chaos,Death,Destruction,Evil|PREALIGN:CE,CN,NE
Nocticula			DOMAINS:Chaos,Evil,Healing,Luck,Plant|PREALIGN:CE,CN,NE
Pazuzu			DOMAINS:Air,Animal,Chaos,Evil|PREALIGN:CE,CN,NE
Raum				DOMAINS:Catastrophe,Chaos,Evil,Prophecy|PREALIGN:CE,CN,NE
Sabnach			DOMAINS:Chaos,Disease,Evil,Protection|PREALIGN:CE,CN,NE
Seere				DOMAINS:Chaos,Evil,Knowledge,Travel|PREALIGN:CE,CN,NE
Shax				DOMAINS:Chaos,Crippling,Evil,Subterfuge|PREALIGN:CE,CN,NE
Socothbenoth		DOMAINS:Chaos,Evil,Pleasure,Trickery|PREALIGN:CE,CN,NE
Vaz'zht			DOMAINS:Chaos,Eloquence,Evil,Subterfuge|PREALIGN:CE,CN,NE
Vepar				DOMAINS:Chaos,Evil,Travel,Water|PREALIGN:CE,CN,NE
Yughooragh			DOMAINS:Animal,Chaos,Death,Evil|PREALIGN:CE,CN,NE
Zhar'Ub-Luur		DOMAINS:Chaos,Eloquence,Evil,Trickery|PREALIGN:CE,CN,NE
