###BLOCK: MASTER
# Spell Name	Unique Key	Classes of caster	Domains granting the spell	
Acid Fog.MOD	CLASSES:Sorcerer,Wizard=6	DOMAINS:Water=7	
Acid Splash.MOD	CLASSES:Sorcerer,Wizard=0	
Aid.MOD	CLASSES:Cleric=2	DOMAINS:Good,Luck=2	
Air Walk.MOD	CLASSES:Cleric,Druid=4	DOMAINS:Air=4	
Alarm.MOD	CLASSES:Bard,Ranger,Sorcerer,Wizard=1	
Align Weapon.MOD	CLASSES:Cleric=2	
Alter Self.MOD	CLASSES:Bard,Sorcerer,Wizard=2	
Analyze Dweomer.MOD	CLASSES:Bard,Sorcerer,Wizard=6	
Animal Growth.MOD	CLASSES:Ranger=4|Druid,Sorcerer,Wizard=5	
Animal Messenger.MOD	CLASSES:Ranger=1|Bard,Druid=2	
Animal Shapes.MOD	CLASSES:Druid=8	DOMAINS:Animal=7	
Animal Trance.MOD	CLASSES:Bard,Druid=2	
Animate Dead.MOD	CLASSES:Cleric=3|Sorcerer,Wizard=4	DOMAINS:Death=3	
Animate Objects.MOD	CLASSES:Bard,Cleric=6	DOMAINS:Chaos=6	
Animate Plants.MOD	CLASSES:Druid=7	DOMAINS:Plant=7	
Animate Rope.MOD	CLASSES:Bard,Sorcerer,Wizard=1	
Antilife Shell.MOD	CLASSES:Cleric,Druid=6	DOMAINS:Animal=6	
Antimagic Field.MOD	CLASSES:Sorcerer,Wizard=6|Cleric=8	DOMAINS:Magic,Protection=6	
Antipathy.MOD	CLASSES:Sorcerer,Wizard=8|Druid=9	
Antiplant Shell.MOD	CLASSES:Druid=4	
Arcane Eye.MOD	CLASSES:Sorcerer,Wizard=4	
Arcane Lock.MOD	CLASSES:Sorcerer,Wizard=2	
Arcane Mark.MOD	CLASSES:Sorcerer,Wizard=0	
Arcane Sight.MOD	CLASSES:Sorcerer,Wizard=3	
Arcane Sight (Greater).MOD	CLASSES:Sorcerer,Wizard=7	
Astral Projection.MOD	CLASSES:Cleric,Sorcerer,Wizard=9	DOMAINS:Travel=9	
Atonement.MOD	CLASSES:Cleric,Druid=5	
Augury.MOD	CLASSES:Cleric=2	
Awaken.MOD	CLASSES:Druid=5	
Baleful Polymorph.MOD	CLASSES:Druid,Sorcerer,Wizard=5	
Bane.MOD	CLASSES:Cleric=1	
Banishment.MOD	CLASSES:Cleric=6|Sorcerer,Wizard=7	
Barkskin.MOD	CLASSES:Druid,Ranger=2	DOMAINS:Plant=2	
Bear's Endurance (Mass).MOD	CLASSES:Cleric,Druid,Sorcerer,Wizard=6	
Bear's Endurance.MOD	CLASSES:Cleric,Druid,Ranger,Sorcerer,Wizard=2	
Bestow Curse.MOD	CLASSES:Cleric=3|Sorcerer,Wizard=4	
Binding.MOD	CLASSES:Sorcerer,Wizard=8	
Blade Barrier.MOD	CLASSES:Cleric=6	DOMAINS:Good,War=6	
Blasphemy.MOD	CLASSES:Cleric=7	DOMAINS:Evil=7	
Bless.MOD	CLASSES:Cleric,Paladin=1	
Bless Water.MOD	CLASSES:Cleric,Paladin=1	
Bless Weapon.MOD	CLASSES:Paladin=1	
Blight.MOD	CLASSES:Druid=4|Sorcerer,Wizard=5	
Blindness/Deafness.MOD	CLASSES:Bard,Sorcerer,Wizard=2|Cleric=3	
Blink.MOD	CLASSES:Bard,Sorcerer,Wizard=3	
Blur.MOD	CLASSES:Bard,Sorcerer,Wizard=2	
Break Enchantment.MOD	CLASSES:Bard,Paladin=4|Cleric,Sorcerer,Wizard=5	DOMAINS:Luck=5	
Bull's Strength.MOD	CLASSES:Cleric,Druid,Paladin,Sorcerer,Wizard=2	DOMAINS:Strength=2	
Bull's Strength (Mass).MOD	CLASSES:Cleric,Druid,Sorcerer,Wizard=6	
Burning Hands.MOD	CLASSES:Sorcerer,Wizard=1	DOMAINS:Fire=1	
Call Lightning Storm.MOD	CLASSES:Druid=5	
Call Lightning.MOD	CLASSES:Druid=3	
Calm Animals.MOD	CLASSES:Druid,Ranger=1	DOMAINS:Animal=1	
Calm Emotions.MOD	CLASSES:Bard,Cleric=2	DOMAINS:Law=2	
Cat's Grace.MOD	CLASSES:Bard,Druid,Ranger,Sorcerer,Wizard=2	
Cat's Grace (Mass).MOD	CLASSES:Bard,Druid,Sorcerer,Wizard=6	
Cause Fear.MOD	CLASSES:Bard,Cleric,Sorcerer,Wizard=1	DOMAINS:Death=1	
Chain Lightning.MOD	CLASSES:Sorcerer,Wizard=6	DOMAINS:Air=6	
Changestaff.MOD	CLASSES:Druid=7	
Chaos Hammer	DOMAINS:Chaos=4	
Charm Animal.MOD	CLASSES:Druid,Ranger=1	
Charm Monster.MOD	CLASSES:Bard=3|Sorcerer,Wizard=4	
Charm Monster (Mass).MOD	CLASSES:Bard=6|Sorcerer,Wizard=8	
Charm Person.MOD	CLASSES:Bard,Sorcerer,Wizard=1	
Chill Metal.MOD	CLASSES:Druid=2	
Chill Touch.MOD	CLASSES:Sorcerer,Wizard=1	
Circle of Death.MOD	CLASSES:Sorcerer,Wizard=6	
Clairaudience/Clairvoyance.MOD	CLASSES:Bard,Sorcerer,Wizard=3	DOMAINS:Knowledge=3	
Cloak of Chaos.MOD	CLASSES:Cleric=8	DOMAINS:Chaos=8	
Clone.MOD	CLASSES:Sorcerer,Wizard=8	
Cloudkill.MOD	CLASSES:Sorcerer,Wizard=5	
Color Spray.MOD	CLASSES:Sorcerer,Wizard=1	
Command.MOD	CLASSES:Cleric=1	
Command (Greater).MOD	CLASSES:Cleric=5	
Command Plants.MOD	CLASSES:Ranger=3|Druid=4	DOMAINS:Plant=4	
Command Undead.MOD	CLASSES:Sorcerer,Wizard=2	
Commune.MOD	CLASSES:Cleric=5	
Commune with Nature.MOD	CLASSES:Ranger=4|Druid=5	DOMAINS:Animal=5	
Comprehend Languages.MOD	CLASSES:Bard,Cleric,Sorcerer,Wizard=1	
Cone of Cold.MOD	CLASSES:Sorcerer,Wizard=5	DOMAINS:Water=6	
Confusion.MOD	CLASSES:Bard=3|Sorcerer,Wizard=4	DOMAINS:Trickery=4	
Confusion (Lesser).MOD	CLASSES:Bard=1	
Consecrate.MOD	CLASSES:Cleric=2	
Contact Other Plane.MOD	CLASSES:Sorcerer,Wizard=5	
Contagion.MOD	CLASSES:Cleric,Druid=3|Sorcerer,Wizard=4	DOMAINS:Destruction=3	
Contingency.MOD	CLASSES:Sorcerer,Wizard=6	
Continual Flame.MOD	CLASSES:Sorcerer,Wizard=2|Cleric=3	
Control Plants.MOD	CLASSES:Druid=8	DOMAINS:Plant=8	
Control Undead.MOD	CLASSES:Sorcerer,Wizard=7	
Control Water.MOD	CLASSES:Cleric,Druid=4|Sorcerer,Wizard=6	DOMAINS:Water=4	
Control Weather.MOD	CLASSES:Cleric,Druid,Sorcerer,Wizard=7	DOMAINS:Air=7	
Control Winds.MOD	CLASSES:Druid=5	DOMAINS:Air=5	
Create Food and Water.MOD	CLASSES:Cleric=3	
Create Greater Undead.MOD	CLASSES:Cleric,Sorcerer,Wizard=8	DOMAINS:Death=8	
Create Undead.MOD	CLASSES:Cleric,Sorcerer,Wizard=6	DOMAINS:Death,Evil=6	
Create Water.MOD	CLASSES:Cleric,Druid=0|Paladin=1	
Creeping Doom.MOD	CLASSES:Druid=7	
Crushing Despair.MOD	CLASSES:Bard=3|Sorcerer,Wizard=4	
Cure Critical Wounds.MOD	CLASSES:Bard,Cleric=4|Druid=5	DOMAINS:Healing=4		
Cure Critical Wounds (Mass).MOD	CLASSES:Cleric=8|Druid=9	DOMAINS:Healing=8	
Cure Light Wounds.MOD	CLASSES:Bard,Cleric,Druid,Paladin=1|Ranger=2	DOMAINS:Healing=1	
Cure Light Wounds (Mass).MOD	CLASSES:Bard,Cleric=5|Druid=6	DOMAINS:Healing=5	
Cure Minor Wounds.MOD	CLASSES:Cleric,Druid=0	
Cure Moderate Wounds.MOD	CLASSES:Bard,Cleric=2|Druid,Paladin,Ranger=3	DOMAINS:Healing=2	
Cure Moderate Wounds (Mass).MOD	CLASSES:Bard,Cleric=6|Druid=7	
Cure Serious Wounds.MOD	CLASSES:Bard,Cleric=3|Druid,Paladin,Ranger=4	DOMAINS:Healing=3	
Cure Serious Wounds (Mass).MOD	CLASSES:Cleric=7|Druid=8	
Curse Water.MOD	CLASSES:Cleric=1	
Dancing Lights.MOD	CLASSES:Bard,Sorcerer,Wizard=0	
Darkness.MOD	CLASSES:Bard,Cleric,Sorcerer,Wizard=2	
Darkvision.MOD	CLASSES:Sorcerer,Wizard=2|Ranger=3	
Daylight.MOD	CLASSES:Bard,Cleric,Druid,Paladin,Sorcerer,Wizard=3	
Daze.MOD	CLASSES:Bard,Sorcerer,Wizard=0	
Daze Monster.MOD	CLASSES:Bard,Sorcerer,Wizard=2	
Death Knell.MOD	CLASSES:Cleric=2	DOMAINS:Death=2	
Death Ward.MOD	CLASSES:Cleric,Paladin=4|Druid=5	DOMAINS:Death=4	
Deathwatch.MOD	CLASSES:Cleric=1	
Deep Slumber.MOD	CLASSES:Bard,Sorcerer,Wizard=3	
Deeper Darkness.MOD	CLASSES:Cleric=3	
Delay Poison.MOD	CLASSES:Ranger=1|Bard,Cleric,Druid,Paladin=2	
Delayed Blast Fireball.MOD	CLASSES:Sorcerer,Wizard=7	
Demand.MOD	CLASSES:Sorcerer,Wizard=8	
Desecrate.MOD	CLASSES:Cleric=2	DOMAINS:Evil=2	
Destruction.MOD	CLASSES:Cleric=7	DOMAINS:Death=7	
Detect Animals or Plants.MOD	CLASSES:Druid,Ranger=1	
Detect Chaos.MOD	CLASSES:Cleric=1	
Detect Evil.MOD	CLASSES:Cleric=1	
Detect Good.MOD	CLASSES:Cleric=1	
Detect Law.MOD	CLASSES:Cleric=1	
Detect Magic.MOD	CLASSES:Bard,Cleric,Druid,Sorcerer,Wizard=0	
Detect Poison.MOD	CLASSES:Cleric,Druid,Sorcerer,Wizard=0|Paladin,Ranger=1	
Detect Scrying.MOD	CLASSES:Bard,Sorcerer,Wizard=4	
Detect Secret Doors.MOD	CLASSES:Bard,Sorcerer,Wizard=1	DOMAINS:Knowledge=1	
Detect Snares and Pits.MOD	CLASSES:Druid,Ranger=1	
Detect Thoughts.MOD	CLASSES:Bard,Sorcerer,Wizard=2	DOMAINS:Knowledge=2	
Detect Undead.MOD	CLASSES:Cleric,Paladin,Sorcerer,Wizard=1	
Dictum.MOD	CLASSES:Cleric=7	DOMAINS:Law=7	
Dimension Door.MOD	CLASSES:Bard,Sorcerer,Wizard=4	DOMAINS:Travel=4	
Dimensional Anchor.MOD	CLASSES:Cleric,Sorcerer,Wizard=4	
Dimensional Lock.MOD	CLASSES:Cleric,Sorcerer,Wizard=8	
Diminish Plants.MOD	CLASSES:Druid,Ranger=3	
Discern Lies.MOD	CLASSES:Paladin=3|Cleric=4	
Discern Location.MOD	CLASSES:Cleric,Sorcerer,Wizard=8	DOMAINS:Knowledge=8	
Disguise Self.MOD	CLASSES:Bard,Sorcerer,Wizard=1	DOMAINS:Trickery=1	
Disintegrate.MOD	CLASSES:Sorcerer,Wizard=6	DOMAINS:Destruction=7	
Dismissal.MOD	CLASSES:Cleric=4|Sorcerer,Wizard=5	
Dispel Chaos.MOD	CLASSES:Paladin=4|Cleric=5	DOMAINS:Law=5	
Dispel Evil.MOD	CLASSES:Paladin=4|Cleric=5	DOMAINS:Good=5	
Dispel Good.MOD	CLASSES:Cleric=5	DOMAINS:Evil=5	
Dispel Law.MOD	CLASSES:Cleric=5	DOMAINS:Chaos=5	
Dispel Magic.MOD	CLASSES:Bard,Cleric,Paladin,Sorcerer,Wizard=3|Druid=4	DOMAINS:Magic=3	
Dispel Magic (Greater).MOD	CLASSES:Bard=5|Cleric,Druid,Sorcerer,Wizard=6	
Displacement.MOD	CLASSES:Bard,Sorcerer,Wizard=3	
Disrupt Undead.MOD	CLASSES:Sorcerer,Wizard=0	
Disrupting Weapon.MOD	CLASSES:Cleric=5	
Divination.MOD	CLASSES:Cleric=4	DOMAINS:Knowledge=4	
Divine Favor.MOD	CLASSES:Cleric,Paladin=1	
Divine Power.MOD	CLASSES:Cleric=4	DOMAINS:War=4	
Dominate Animal.MOD	CLASSES:Druid=3	DOMAINS:Animal=3	
Dominate Monster.MOD	CLASSES:Sorcerer,Wizard=9	
Dominate Person.MOD	CLASSES:Bard=4|Sorcerer,Wizard=5	
Doom.MOD	CLASSES:Cleric=1	
Dream.MOD	CLASSES:Bard,Sorcerer,Wizard=5	
Eagle's Splendor.MOD	CLASSES:Bard,Cleric,Paladin,Sorcerer,Wizard=2	
Eagle's Splendor (Mass).MOD	CLASSES:Bard,Cleric,Sorcerer,Wizard=6	
Earthquake.MOD	CLASSES:Cleric,Druid=8	DOMAINS:Earth=7|Destruction=8	
Elemental Swarm.MOD	CLASSES:Druid=9	DOMAINS:Air,Earth,Fire,Water=9	
Endure Elements.MOD	CLASSES:Cleric,Druid,Paladin,Ranger,Sorcerer,Wizard=1	DOMAINS:Sun=1	
Energy Drain.MOD	CLASSES:Cleric,Sorcerer,Wizard=9	
Enervation.MOD	CLASSES:Sorcerer,Wizard=4	
Enlarge Person.MOD	CLASSES:Sorcerer,Wizard=1	DOMAINS:Strength=1	
Enlarge Person (Mass).MOD	CLASSES:Sorcerer,Wizard=4	
Entangle.MOD	CLASSES:Druid,Ranger=1	DOMAINS:Plant=1	
Enthrall.MOD	CLASSES:Bard,Cleric=2	
Entropic Shield.MOD	CLASSES:Cleric=1	DOMAINS:Luck=1	
Erase.MOD	CLASSES:Bard,Sorcerer,Wizard=1	
Ethereal Jaunt.MOD	CLASSES:Cleric,Sorcerer,Wizard=7	
Etherealness.MOD	CLASSES:Cleric,Sorcerer,Wizard=9	
Expeditious Retreat.MOD	CLASSES:Bard,Sorcerer,Wizard=1	
Explosive Runes.MOD	CLASSES:Sorcerer,Wizard=3	
Eyebite.MOD	CLASSES:Bard,Sorcerer,Wizard=6	
Fabricate.MOD	CLASSES:Sorcerer,Wizard=5	
Faerie Fire.MOD	CLASSES:Druid=1	
False Life.MOD	CLASSES:Sorcerer,Wizard=2	
False Vision.MOD	CLASSES:Bard,Sorcerer,Wizard=5	DOMAINS:Trickery=5	
Fear.MOD	CLASSES:Bard=3|Sorcerer,Wizard=4	
Feather Fall.MOD	CLASSES:Bard,Sorcerer,Wizard=1	
Feeblemind.MOD	CLASSES:Sorcerer,Wizard=5	
Find the Path.MOD	CLASSES:Bard,Cleric,Druid=6	DOMAINS:Knowledge,Travel=6	
Find Traps.MOD	CLASSES:Cleric=2	
Finger of Death.MOD	CLASSES:Sorcerer,Wizard=7|Druid=8	
Fire Seeds.MOD	CLASSES:Druid=6	DOMAINS:Fire,Sun=6	
Fire Shield.MOD	CLASSES:Sorcerer,Wizard=4	DOMAINS:Sun=4|Fire=5	
Fire Storm.MOD	CLASSES:Druid=7|Cleric=8	DOMAINS:Fire=7	
Fire Trap.MOD	CLASSES:Druid=2|Sorcerer,Wizard=4	
Fireball.MOD	CLASSES:Sorcerer,Wizard=3	
Flame Arrow.MOD	CLASSES:Sorcerer,Wizard=3	
Flame Blade.MOD	CLASSES:Druid=2	
Flame Strike.MOD	CLASSES:Druid=4|Cleric=5	DOMAINS:Sun,War=5	
Flaming Sphere.MOD	CLASSES:Druid,Sorcerer,Wizard=2	
Flare.MOD	CLASSES:Bard,Druid,Sorcerer,Wizard=0	
Flesh to Stone.MOD	CLASSES:Sorcerer,Wizard=6	
Fly.MOD	CLASSES:Sorcerer,Wizard=3	DOMAINS:Travel=3	
Fog Cloud.MOD	CLASSES:Druid,Sorcerer,Wizard=2	DOMAINS:Water=2	
Forbiddance.MOD	CLASSES:Cleric=6	
Forcecage.MOD	CLASSES:Sorcerer,Wizard=7	
Foresight.MOD	CLASSES:Druid,Sorcerer,Wizard=9	DOMAINS:Knowledge=9	
Fox's Cunning.MOD	CLASSES:Bard,Sorcerer,Wizard=2	
Fox's Cunning (Mass).MOD	CLASSES:Bard,Sorcerer,Wizard=6	
Freedom.MOD	CLASSES:Sorcerer,Wizard=9	
Freedom of Movement.MOD	CLASSES:Bard,Cleric,Druid,Ranger=4	DOMAINS:Luck=4	
Gaseous Form.MOD	CLASSES:Bard,Sorcerer,Wizard=3	DOMAINS:Air=3	
Gate.MOD	CLASSES:Cleric,Sorcerer,Wizard=9	
Geas/Quest.MOD	CLASSES:Bard,Cleric,Sorcerer,Wizard=6	
Geas (Lesser).MOD	CLASSES:Bard=3|Sorcerer,Wizard=4	
Gentle Repose.MOD	CLASSES:Cleric=2|Sorcerer,Wizard=3	
Ghost Sound.MOD	CLASSES:Bard,Sorcerer,Wizard=0	
Ghoul Touch.MOD	CLASSES:Sorcerer,Wizard=2	
Giant Vermin.MOD	CLASSES:Cleric,Druid=4	
Glibness.MOD	CLASSES:Bard=3	
Glitterdust.MOD	CLASSES:Bard,Sorcerer,Wizard=2	
Globe of Invulnerability.MOD	CLASSES:Sorcerer,Wizard=6	
Globe of Invulnerability (Lesser).MOD	CLASSES:Sorcerer,Wizard=4	
Glyph of Warding.MOD	CLASSES:Cleric=3		
Glyph of Warding (Greater).MOD	CLASSES:Cleric=6	
Goodberry.MOD	CLASSES:Druid=1	
Good Hope.MOD	CLASSES:Bard=3	
Grease.MOD	CLASSES:Bard,Sorcerer,Wizard=1	
Guards and Wards.MOD	CLASSES:Sorcerer,Wizard=6	
Guidance.MOD	CLASSES:Cleric,Druid=0	
Gust of Wind.MOD	CLASSES:Druid,Sorcerer,Wizard=2	
Hallow.MOD	CLASSES:Cleric,Druid=5	
Hallucinatory Terrain.MOD	CLASSES:Bard,Sorcerer,Wizard=4	
Halt Undead.MOD	CLASSES:Sorcerer,Wizard=3	
Harm.MOD	CLASSES:Cleric=6	DOMAINS:Destruction=6	
Haste.MOD	CLASSES:Bard,Sorcerer,Wizard=3	
Heal.MOD	CLASSES:Cleric=6|Druid=7	DOMAINS:Healing=6		

Heal (Mass).MOD	CLASSES:Cleric=9	DOMAINS:Healing=9	
Heal Mount.MOD	CLASSES:Paladin=3	
Heat Metal.MOD	CLASSES:Druid=2	DOMAINS:Sun=2	
Helping Hand.MOD	CLASSES:Cleric=3	
Heroes' Feast.MOD	CLASSES:Bard,Cleric=6	
Heroism.MOD	CLASSES:Bard=2|Sorcerer,Wizard=3		

Heroism (Greater).MOD	CLASSES:Bard=5|Sorcerer,Wizard=6	
Hide from Animals.MOD	CLASSES:Druid,Ranger=1	
Hide from Undead.MOD	CLASSES:Cleric=1	
Hold Animal.MOD	CLASSES:Druid,Ranger=2	DOMAINS:Animal=2	
Hold Monster.MOD	CLASSES:Bard=4|Sorcerer,Wizard=5	DOMAINS:Law=6		

Hold Monster (Mass).MOD	CLASSES:Sorcerer,Wizard=9	
Hold Person.MOD	CLASSES:Bard,Cleric=2|Sorcerer,Wizard=3		

Hold Person (Mass).MOD	CLASSES:Sorcerer,Wizard=7	
Hold Portal.MOD	CLASSES:Sorcerer,Wizard=1	
Holy Aura.MOD	CLASSES:Cleric=8	DOMAINS:Good=8	
Holy Smite	DOMAINS:Good=4	
Holy Sword.MOD	CLASSES:Paladin=4	
Holy Word.MOD	CLASSES:Cleric=7	DOMAINS:Good=7	
Horrid Wilting.MOD	CLASSES:Sorcerer,Wizard=8	DOMAINS:Water=8	
Hypnotic Pattern.MOD	CLASSES:Bard,Sorcerer,Wizard=2	
Hypnotism.MOD	CLASSES:Bard,Sorcerer,Wizard=1	
Ice Storm.MOD	CLASSES:Druid,Sorcerer,Wizard=4	DOMAINS:Water=5	
Identify.MOD	CLASSES:Bard,Sorcerer,Wizard=1	DOMAINS:Magic=2	
Illusory Script.MOD	CLASSES:Bard,Sorcerer,Wizard=3	
Illusory Wall.MOD	CLASSES:Sorcerer,Wizard=4	
Imbue with Spell Ability.MOD	CLASSES:Cleric=4	DOMAINS:Magic=4	
Implosion.MOD	CLASSES:Cleric=9	DOMAINS:Destruction=9	
Imprisonment.MOD	CLASSES:Sorcerer,Wizard=9	
Incendiary Cloud.MOD	CLASSES:Sorcerer,Wizard=8	DOMAINS:Fire=8	
Inflict Critical Wounds.MOD	CLASSES:Cleric=4	DOMAINS:Destruction=4		

Inflict Critical Wounds (Mass).MOD	CLASSES:Cleric=8	
Inflict Light Wounds.MOD	CLASSES:Cleric=1	DOMAINS:Destruction=1		

Inflict Light Wounds (Mass).MOD	CLASSES:Cleric=5	DOMAINS:Destruction=5	
Inflict Minor Wounds.MOD	CLASSES:Cleric=0	
Inflict Moderate Wounds.MOD	CLASSES:Cleric=2		
Inflict Moderate Wounds (Mass).MOD	CLASSES:Cleric=6	
Inflict Serious Wounds.MOD	CLASSES:Cleric=3		
Inflict Serious Wounds (Mass).MOD	CLASSES:Cleric=7	
Insanity.MOD	CLASSES:Sorcerer,Wizard=7	
Insect Plague.MOD	CLASSES:Cleric,Druid=5	
Invisibility.MOD	CLASSES:Bard,Sorcerer,Wizard=2	DOMAINS:Trickery=2	
Invisibility (Greater).MOD	CLASSES:Bard,Sorcerer,Wizard=4	
Invisibility (Mass).MOD	CLASSES:Sorcerer,Wizard=7	
Invisibility Purge.MOD	CLASSES:Cleric=3	
Invisibility Sphere.MOD	CLASSES:Bard,Sorcerer,Wizard=3	
Iron Body.MOD	CLASSES:Sorcerer,Wizard=8	DOMAINS:Earth=8	
Ironwood.MOD	CLASSES:Druid=6	
Jump.MOD	CLASSES:Druid,Ranger,Sorcerer,Wizard=1	
Keen Edge.MOD	CLASSES:Sorcerer,Wizard=3	
Knock.MOD	CLASSES:Sorcerer,Wizard=2	
Know Direction.MOD	CLASSES:Bard,Druid=0	
Legend Lore.MOD	CLASSES:Bard=4|Sorcerer,Wizard=6	DOMAINS:Knowledge=7	
Levitate.MOD	CLASSES:Sorcerer,Wizard=2	
Light.MOD	CLASSES:Bard,Cleric,Druid,Sorcerer,Wizard=0	
Lightning Bolt.MOD	CLASSES:Sorcerer,Wizard=3	
Limited Wish.MOD	CLASSES:Sorcerer,Wizard=7	
Liveoak.MOD	CLASSES:Druid=6	
Locate Creature.MOD	CLASSES:Bard,Sorcerer,Wizard=4	
Locate Object.MOD	CLASSES:Bard,Sorcerer,Wizard=2|Cleric=3	DOMAINS:Travel=2	
Longstrider.MOD	CLASSES:Druid,Ranger=1	DOMAINS:Travel=1	
Lullaby.MOD	CLASSES:Bard=0	
Mage Armor.MOD	CLASSES:Sorcerer,Wizard=1	
Mage Hand.MOD	CLASSES:Bard,Sorcerer,Wizard=0	
Magic Circle against Chaos.MOD	CLASSES:Cleric,Paladin,Sorcerer,Wizard=3	DOMAINS:Law=3	
Magic Circle against Evil.MOD	CLASSES:Cleric,Paladin,Sorcerer,Wizard=3	DOMAINS:Good=3	
Magic Circle against Good.MOD	CLASSES:Cleric,Sorcerer,Wizard=3	DOMAINS:Evil=3	
Magic Circle against Law.MOD	CLASSES:Cleric,Sorcerer,Wizard=3	DOMAINS:Chaos=3	
Magic Fang.MOD	CLASSES:Druid,Ranger=1	
Magic Fang (Greater).MOD	CLASSES:Druid,Ranger=3	
Magic Jar.MOD	CLASSES:Sorcerer,Wizard=5	
Magic Missile.MOD	CLASSES:Sorcerer,Wizard=1	
Magic Mouth.MOD	CLASSES:Bard=1|Sorcerer,Wizard=2	
Magic Stone.MOD	CLASSES:Cleric,Druid=1	DOMAINS:Earth=1	
Magic Vestment.MOD	CLASSES:Cleric=3	DOMAINS:Strength,War=3	
Magic Weapon.MOD	CLASSES:Cleric,Paladin,Sorcerer,Wizard=1	DOMAINS:War=1	
Magic Weapon (Greater).MOD	CLASSES:Paladin,Sorcerer,Wizard=3|Cleric=4	
Major Creation.MOD	CLASSES:Sorcerer,Wizard=5	
Major Image.MOD	CLASSES:Bard,Sorcerer,Wizard=3	
Make Whole.MOD	CLASSES:Cleric=2	
Mark of Justice.MOD	CLASSES:Paladin=4|Cleric=5	
Maze.MOD	CLASSES:Sorcerer,Wizard=8	
Meld into Stone.MOD	CLASSES:Cleric,Druid=3	
Mending.MOD	CLASSES:Bard,Cleric,Druid,Sorcerer,Wizard=0	
Message.MOD	CLASSES:Bard,Sorcerer,Wizard=0	
Meteor Swarm.MOD	CLASSES:Sorcerer,Wizard=9	
Mind Blank.MOD	CLASSES:Sorcerer,Wizard=8	DOMAINS:Protection=8	
Mind Fog.MOD	CLASSES:Bard,Sorcerer,Wizard=5	
Minor Creation.MOD	CLASSES:Sorcerer,Wizard=4	
Minor Image.MOD	CLASSES:Bard,Sorcerer,Wizard=2	
Miracle.MOD	CLASSES:Cleric=9	DOMAINS:Luck=9	
Mirage Arcana.MOD	CLASSES:Bard,Sorcerer,Wizard=5	
Mirror Image.MOD	CLASSES:Bard,Sorcerer,Wizard=2	
Misdirection.MOD	CLASSES:Bard,Sorcerer,Wizard=2	
Mislead.MOD	CLASSES:Bard=5|Sorcerer,Wizard=6	DOMAINS:Luck,Trickery=6	
Modify Memory.MOD	CLASSES:Bard=4	
Moment of Prescience.MOD	CLASSES:Sorcerer,Wizard=8	DOMAINS:Luck=8	
Mount.MOD	CLASSES:Sorcerer,Wizard=1	
Move Earth.MOD	CLASSES:Druid,Sorcerer,Wizard=6	
Neutralize Poison.MOD	CLASSES:Druid,Ranger=3|Bard,Cleric,Paladin=4	
Nightmare.MOD	CLASSES:Bard,Sorcerer,Wizard=5	
Nondetection.MOD	CLASSES:Sorcerer,Wizard=3|Ranger=4	DOMAINS:Trickery=3	
Obscure Object.MOD	CLASSES:Bard=1|Sorcerer,Wizard=2|Cleric=3	
Obscuring Mist.MOD	CLASSES:Cleric,Druid,Sorcerer,Wizard=1	DOMAINS:Air,Water=1	
Open/Close.MOD	CLASSES:Bard,Sorcerer,Wizard=0	
Order's Wrath	DOMAINS:Law=4	
Overland Flight.MOD	CLASSES:Sorcerer,Wizard=5	
Owl's Wisdom.MOD	CLASSES:Cleric,Druid,Paladin,Ranger,Sorcerer,Wizard=2	
Owl's Wisdom (Mass).MOD	CLASSES:Cleric,Druid,Sorcerer,Wizard=6	
Passwall.MOD	CLASSES:Sorcerer,Wizard=5	
Pass without Trace.MOD	CLASSES:Druid,Ranger=1	
Permanency.MOD	CLASSES:Sorcerer,Wizard=5	
Permanent Image.MOD	CLASSES:Bard,Sorcerer,Wizard=6	
Persistent Image.MOD	CLASSES:Bard,Sorcerer,Wizard=5	
Phantasmal Killer.MOD	CLASSES:Sorcerer,Wizard=4	
Phantom Steed.MOD	CLASSES:Bard,Sorcerer,Wizard=3	
Phase Door.MOD	CLASSES:Sorcerer,Wizard=7	DOMAINS:Travel=8	
Planar Ally.MOD	CLASSES:Cleric=6	
Planar Ally (Greater).MOD	CLASSES:Cleric=8	
Planar Ally (Lesser).MOD	CLASSES:Cleric=4	
Planar Binding.MOD	CLASSES:Sorcerer,Wizard=6	
Planar Binding (Greater).MOD	CLASSES:Sorcerer,Wizard=8	
Planar Binding (Lesser).MOD	CLASSES:Sorcerer,Wizard=5	
Plane Shift.MOD	CLASSES:Cleric=5|Sorcerer,Wizard=7	
Plant Growth.MOD	CLASSES:Druid,Ranger=3	DOMAINS:Plant=3	
Poison.MOD	CLASSES:Druid=3|Cleric=4	
Polar Ray.MOD	CLASSES:Sorcerer,Wizard=8	
Polymorph.MOD	CLASSES:Sorcerer,Wizard=4	
Polymorph Any Object.MOD	CLASSES:Sorcerer,Wizard=8	DOMAINS:Trickery=8	
Power Word Blind.MOD	CLASSES:Sorcerer,Wizard=7	DOMAINS:War=7	
Power Word Kill.MOD	CLASSES:Sorcerer,Wizard=9	DOMAINS:War=9	
Power Word Stun.MOD	CLASSES:Sorcerer,Wizard=8	DOMAINS:War=8	
Prayer.MOD	CLASSES:Cleric,Paladin=3	
Prestidigitation.MOD	CLASSES:Bard,Sorcerer,Wizard=0	
Prismatic Sphere.MOD	CLASSES:Sorcerer,Wizard=9	DOMAINS:Protection,Sun=9	
Prismatic Spray.MOD	CLASSES:Sorcerer,Wizard=7	
Prismatic Wall.MOD	CLASSES:Sorcerer,Wizard=8	
Produce Flame.MOD	CLASSES:Druid=1	DOMAINS:Fire=2	
Programmed Image.MOD	CLASSES:Bard,Sorcerer,Wizard=6	
Project Image.MOD	CLASSES:Bard=6|Sorcerer,Wizard=7	
Protection from Arrows.MOD	CLASSES:Sorcerer,Wizard=2	
Protection from Chaos.MOD	CLASSES:Cleric,Paladin,Sorcerer,Wizard=1	DOMAINS:Law=1	
Protection from Energy.MOD	CLASSES:Ranger=2|Cleric,Druid,Sorcerer,Wizard=3	DOMAINS:Luck,Protection=3	
Protection from Evil.MOD	CLASSES:Cleric,Paladin,Sorcerer,Wizard=1	DOMAINS:Good=1	
Protection from Good.MOD	CLASSES:Cleric,Sorcerer,Wizard=1	DOMAINS:Evil=1	
Protection from Law.MOD	CLASSES:Cleric,Sorcerer,Wizard=1	DOMAINS:Chaos=1	
Protection from Spells.MOD	CLASSES:Sorcerer,Wizard=8	DOMAINS:Magic=8	
Prying Eyes.MOD	CLASSES:Sorcerer,Wizard=5	
Prying Eyes (Greater).MOD	CLASSES:Sorcerer,Wizard=8	
Purify Food and Drink.MOD	CLASSES:Cleric,Druid=0	
Pyrotechnics.MOD	CLASSES:Bard,Sorcerer,Wizard=2	
Quench.MOD	CLASSES:Druid=3	
Rage.MOD	CLASSES:Bard=2|Sorcerer,Wizard=3	
Rainbow Pattern.MOD	CLASSES:Bard,Sorcerer,Wizard=4	
Raise Dead.MOD	CLASSES:Cleric=5	
Ray of Enfeeblement.MOD	CLASSES:Sorcerer,Wizard=1	
Ray of Exhaustion.MOD	CLASSES:Sorcerer,Wizard=3	
Ray of Frost.MOD	CLASSES:Sorcerer,Wizard=0	
Read Magic.MOD	CLASSES:Bard,Cleric,Druid,Sorcerer,Wizard=0|Paladin,Ranger=1	
Reduce Animal.MOD	CLASSES:Druid=2|Ranger=3	
Reduce Person.MOD	CLASSES:Sorcerer,Wizard=1	
Reduce Person (Mass).MOD	CLASSES:Sorcerer,Wizard=4	
Refuge.MOD	CLASSES:Cleric=7|Sorcerer,Wizard=9	
Regenerate.MOD	CLASSES:Cleric=7|Druid=9	DOMAINS:Healing=7	
Reincarnate.MOD	CLASSES:Druid=4	
Remove Blindness/Deafness.MOD	CLASSES:Cleric,Paladin=3	
Remove Curse.MOD	CLASSES:Bard,Cleric,Paladin=3|Sorcerer,Wizard=4	
Remove Disease.MOD	CLASSES:Cleric,Druid,Ranger=3	
Remove Fear.MOD	CLASSES:Bard,Cleric=1	
Remove Paralysis.MOD	CLASSES:Cleric,Paladin=2	
Repel Metal or Stone.MOD	CLASSES:Druid=8	
Repel Vermin.MOD	CLASSES:Ranger=3|Bard,Cleric,Druid=4	
Repel Wood.MOD	CLASSES:Druid=6	DOMAINS:Plant=6	
Repulsion.MOD	CLASSES:Sorcerer,Wizard=6|Cleric=7	DOMAINS:Protection=7	
Resistance.MOD	CLASSES:Bard,Cleric,Druid,Sorcerer,Wizard=0|Paladin=1	
Resist Energy.MOD	CLASSES:Ranger=1|Cleric,Druid,Paladin,Sorcerer,Wizard=2	DOMAINS:Fire=3	
Restoration.MOD	CLASSES:Cleric,Paladin=4	
Restoration (Greater).MOD	CLASSES:Cleric=7	
Restoration (Lesser).MOD	CLASSES:Paladin=1|Cleric,Druid=2	
Resurrection.MOD	CLASSES:Cleric=7	
Reverse Gravity.MOD	CLASSES:Sorcerer,Wizard=7|Druid=8	
Righteous Might.MOD	CLASSES:Cleric=5	DOMAINS:Strength=5	
Rope Trick.MOD	CLASSES:Sorcerer,Wizard=2	
Rusting Grasp.MOD	CLASSES:Druid=4	
Sanctuary.MOD	CLASSES:Cleric=1	DOMAINS:Protection=1	
Scare.MOD	CLASSES:Bard,Sorcerer,Wizard=2	
Scintillating Pattern.MOD	CLASSES:Sorcerer,Wizard=8	
Scorching Ray.MOD	CLASSES:Sorcerer,Wizard=2	
Screen.MOD	CLASSES:Sorcerer,Wizard=8	DOMAINS:Trickery=7	
Scrying.MOD	CLASSES:Bard=3|Druid,Sorcerer,Wizard=4|Cleric=5	
Scrying (Greater).MOD	CLASSES:Bard=6|Cleric,Druid,Sorcerer,Wizard=7	
Sculpt Sound.MOD	CLASSES:Bard=3	
Searing Light.MOD	CLASSES:Cleric=3	DOMAINS:Sun=3	
Secret Page.MOD	CLASSES:Bard,Sorcerer,Wizard=3	
See Invisibility.MOD	CLASSES:Sorcerer,Wizard=2|Bard=3	
Seeming.MOD	CLASSES:Bard,Sorcerer,Wizard=5	
Sending.MOD	CLASSES:Cleric=4|Sorcerer,Wizard=5	
Sepia Snake Sigil.MOD	CLASSES:Bard,Sorcerer,Wizard=3	
Sequester.MOD	CLASSES:Sorcerer,Wizard=7	
Shades.MOD	CLASSES:Sorcerer,Wizard=9	
Shadow Conjuration.MOD	CLASSES:Bard,Sorcerer,Wizard=4	
Shadow Conjuration (Greater).MOD	CLASSES:Sorcerer,Wizard=7	
Shadow Evocation.MOD	CLASSES:Bard,Sorcerer,Wizard=5	
Shadow Evocation (Greater).MOD	CLASSES:Sorcerer,Wizard=8	
Shadow Walk.MOD	CLASSES:Bard=5|Sorcerer,Wizard=6	
Shambler.MOD	CLASSES:Druid=9	DOMAINS:Plant=9	
Shapechange.MOD	CLASSES:Druid,Sorcerer,Wizard=9	DOMAINS:Animal=9	
Shatter.MOD	CLASSES:Bard,Cleric,Sorcerer,Wizard=2	DOMAINS:Chaos,Destruction=2	
Shield.MOD	CLASSES:Sorcerer,Wizard=1	
Shield of Faith.MOD	CLASSES:Cleric=1	
Shield of Law.MOD	CLASSES:Cleric=8	DOMAINS:Law=8	
Shield Other.MOD	CLASSES:Cleric,Paladin=2	DOMAINS:Protection=2	
Shillelagh.MOD	CLASSES:Druid=1	
Shocking Grasp.MOD	CLASSES:Sorcerer,Wizard=1	
Shout.MOD	CLASSES:Bard,Sorcerer,Wizard=4	
Shout (Greater).MOD	CLASSES:Bard=6|Sorcerer,Wizard=8	
Shrink Item.MOD	CLASSES:Sorcerer,Wizard=3	
Silence.MOD	CLASSES:Bard,Cleric=2	
Silent Image.MOD	CLASSES:Bard,Sorcerer,Wizard=1	
Simulacrum.MOD	CLASSES:Sorcerer,Wizard=7	
Slay Living.MOD	CLASSES:Cleric=5	DOMAINS:Death=5	
Sleep.MOD	CLASSES:Bard,Sorcerer,Wizard=1	
Sleet Storm.MOD	CLASSES:Druid,Sorcerer,Wizard=3	
Slow.MOD	CLASSES:Bard,Sorcerer,Wizard=3	
Snare.MOD	CLASSES:Ranger=2|Druid=3	
Soften Earth and Stone.MOD	CLASSES:Druid=2	DOMAINS:Earth=2	
Solid Fog.MOD	CLASSES:Sorcerer,Wizard=4	
Song of Discord.MOD	CLASSES:Bard=5	
Soul Bind.MOD	CLASSES:Cleric,Sorcerer,Wizard=9	
Sound Burst.MOD	CLASSES:Bard,Cleric=2	
Speak with Animals.MOD	CLASSES:Druid,Ranger=1|Bard=3	
Speak with Dead.MOD	CLASSES:Cleric=3	
Speak with Plants.MOD	CLASSES:Ranger=2|Druid=3|Bard=4	
Spectral Hand.MOD	CLASSES:Sorcerer,Wizard=2	
Spell Immunity.MOD	CLASSES:Cleric=4	DOMAINS:Protection,Strength=4	
Spell Immunity (Greater).MOD	CLASSES:Cleric=8	
Spell Resistance.MOD	CLASSES:Cleric=5	DOMAINS:Magic,Protection=5	
Spellstaff.MOD	CLASSES:Druid=6	
Spell Turning.MOD	CLASSES:Sorcerer,Wizard=7	DOMAINS:Luck,Magic=7	
Spider Climb.MOD	CLASSES:Druid,Sorcerer,Wizard=2	
Spike Growth.MOD	CLASSES:Ranger=2|Druid=3	
Spike Stones.MOD	CLASSES:Druid=4	DOMAINS:Earth=4	
Spiritual Weapon.MOD	CLASSES:Cleric=2	DOMAINS:War=2	
Statue.MOD	CLASSES:Sorcerer,Wizard=7	
Status.MOD	CLASSES:Cleric=2	
Stinking Cloud.MOD	CLASSES:Sorcerer,Wizard=3	
Stone Shape.MOD	CLASSES:Cleric,Druid=3|Sorcerer,Wizard=4	DOMAINS:Earth=3	
Stoneskin.MOD	CLASSES:Sorcerer,Wizard=4|Druid=5	DOMAINS:Earth,Strength=6	
Stone Tell.MOD	CLASSES:Druid=6	
Stone to Flesh.MOD	CLASSES:Sorcerer,Wizard=6	
Storm of Vengeance.MOD	CLASSES:Cleric,Druid=9	
Suggestion.MOD	CLASSES:Bard=2|Sorcerer,Wizard=3	
Suggestion (Mass).MOD	CLASSES:Bard=5|Sorcerer,Wizard=6	
Summon Instrument.MOD	CLASSES:Bard=0	
Summon Monster I.MOD	CLASSES:Bard,Cleric,Sorcerer,Wizard=1	
Summon Monster II.MOD	CLASSES:Bard,Cleric,Sorcerer,Wizard=2	
Summon Monster III.MOD	CLASSES:Bard,Cleric,Sorcerer,Wizard=3	
Summon Monster IV.MOD	CLASSES:Bard,Cleric,Sorcerer,Wizard=4	
Summon Monster V.MOD	CLASSES:Bard,Cleric,Sorcerer,Wizard=5	
Summon Monster VI.MOD	CLASSES:Bard,Cleric,Sorcerer,Wizard=6	
Summon Monster VII.MOD	CLASSES:Cleric,Sorcerer,Wizard=7	
Summon Monster VIII.MOD	CLASSES:Cleric,Sorcerer,Wizard=8	
Summon Monster IX.MOD	CLASSES:Cleric,Sorcerer,Wizard=9	DOMAINS:Chaos,Evil,Good,Law=9	
Summon Nature's Ally I.MOD	CLASSES:Druid,Ranger=1	
Summon Nature's Ally II.MOD	CLASSES:Druid,Ranger=2	
Summon Nature's Ally III.MOD	CLASSES:Druid,Ranger=3	
Summon Nature's Ally IV.MOD	CLASSES:Druid,Ranger=4	DOMAINS:Animal=4	
Summon Nature's Ally V.MOD	CLASSES:Druid=5	
Summon Nature's Ally VI.MOD	CLASSES:Druid=6	
Summon Nature's Ally VII.MOD	CLASSES:Druid=7	
Summon Nature's Ally VIII.MOD	CLASSES:Druid=8	DOMAINS:Animal=8	
Summon Nature's Ally IX.MOD	CLASSES:Druid=9	
Summon Swarm.MOD	CLASSES:Bard,Druid,Sorcerer,Wizard=2	
Sunbeam.MOD	CLASSES:Druid=7	DOMAINS:Sun=7	
Sunburst.MOD	CLASSES:Druid,Sorcerer,Wizard=8	DOMAINS:Sun=8	
Symbol of Death.MOD	CLASSES:Cleric,Sorcerer,Wizard=8	
Symbol of Fear.MOD	CLASSES:Cleric,Sorcerer,Wizard=6	
Symbol of Insanity.MOD	CLASSES:Cleric,Sorcerer,Wizard=8	
Symbol of Pain.MOD	CLASSES:Cleric,Sorcerer,Wizard=5	
Symbol of Persuasion.MOD	CLASSES:Cleric,Sorcerer,Wizard=6	
Symbol of Sleep.MOD	CLASSES:Cleric,Sorcerer,Wizard=5	
Symbol of Stunning.MOD	CLASSES:Cleric,Sorcerer,Wizard=7	
Symbol of Weakness.MOD	CLASSES:Cleric,Sorcerer,Wizard=7	
Sympathetic Vibration.MOD	CLASSES:Bard=6	
Sympathy.MOD	CLASSES:Sorcerer,Wizard=8|Druid=9	
Telekinesis.MOD	CLASSES:Sorcerer,Wizard=5	
Teleport.MOD	CLASSES:Sorcerer,Wizard=5	DOMAINS:Travel=5	
Teleport Object.MOD	CLASSES:Sorcerer,Wizard=7	
Teleport (Greater).MOD	CLASSES:Sorcerer,Wizard=7	DOMAINS:Travel=7	
Teleportation Circle.MOD	CLASSES:Sorcerer,Wizard=9	
Temporal Stasis.MOD	CLASSES:Sorcerer,Wizard=8	
Time Stop.MOD	CLASSES:Sorcerer,Wizard=9	DOMAINS:Trickery=9	
Tongues.MOD	CLASSES:Bard=2|Sorcerer,Wizard=3|Cleric=4	
Touch of Fatigue.MOD	CLASSES:Sorcerer,Wizard=0	
Touch of Idiocy.MOD	CLASSES:Sorcerer,Wizard=2	
Transmute Metal to Wood.MOD	CLASSES:Druid=7	
Transmute Mud to Rock.MOD	CLASSES:Druid,Sorcerer,Wizard=5	
Transmute Rock to Mud.MOD	CLASSES:Druid,Sorcerer,Wizard=5	
Transport via Plants.MOD	CLASSES:Druid=6	
Trap the Soul.MOD	CLASSES:Sorcerer,Wizard=8	
Tree Shape.MOD	CLASSES:Druid=2|Ranger=3	
Tree Stride.MOD	CLASSES:Ranger=4|Druid=5	
True Resurrection.MOD	CLASSES:Cleric=9	
True Seeing.MOD	CLASSES:Cleric=5|Sorcerer,Wizard=6|Druid=7	DOMAINS:Knowledge=5	
True Strike.MOD	CLASSES:Sorcerer,Wizard=1	
Undeath to Death.MOD	CLASSES:Cleric,Sorcerer,Wizard=6	
Undetectable Alignment.MOD	CLASSES:Bard=1|Cleric,Paladin=2	
Unhallow.MOD	CLASSES:Cleric,Druid=5	
Unholy Aura.MOD	CLASSES:Cleric=8	DOMAINS:Evil=8	
Unholy Blight	DOMAINS:Evil=4	
Unseen Servant.MOD	CLASSES:Bard,Sorcerer,Wizard=1	
Vampiric Touch.MOD	CLASSES:Sorcerer,Wizard=3	
Veil.MOD	CLASSES:Bard,Sorcerer,Wizard=6	
Ventriloquism.MOD	CLASSES:Bard,Sorcerer,Wizard=1	
Virtue.MOD	CLASSES:Cleric,Druid=0|Paladin=1	
Vision.MOD	CLASSES:Sorcerer,Wizard=7	
Wail of the Banshee.MOD	CLASSES:Sorcerer,Wizard=9	DOMAINS:Death=9	
Wall of Fire.MOD	CLASSES:Sorcerer,Wizard=4|Druid=5	DOMAINS:Fire=4	
Wall of Force.MOD	CLASSES:Sorcerer,Wizard=5	
Wall of Ice.MOD	CLASSES:Sorcerer,Wizard=4	
Wall of Iron.MOD	CLASSES:Sorcerer,Wizard=6	
Wall of Stone.MOD	CLASSES:Cleric,Sorcerer,Wizard=5|Druid=6	DOMAINS:Earth=5	
Wall of Thorns.MOD	CLASSES:Druid=5	DOMAINS:Plant=5	
Warp Wood.MOD	CLASSES:Druid=2	
Water Breathing.MOD	CLASSES:Cleric,Druid,Sorcerer,Wizard=3	DOMAINS:Water=3	
Water Walk.MOD	CLASSES:Cleric,Ranger=3	
Waves of Exhaustion.MOD	CLASSES:Sorcerer,Wizard=7	
Waves of Fatigue.MOD	CLASSES:Sorcerer,Wizard=5	
Web.MOD	CLASSES:Sorcerer,Wizard=2	
Weird.MOD	CLASSES:Sorcerer,Wizard=9	
Whirlwind.MOD	CLASSES:Druid=8	DOMAINS:Air=8	
Whispering Wind.MOD	CLASSES:Bard,Sorcerer,Wizard=2	
Wind Walk.MOD	CLASSES:Cleric=6|Druid=7	
Wind Wall.MOD	CLASSES:Ranger=2|Cleric,Druid,Sorcerer,Wizard=3	DOMAINS:Air=2	
Wish.MOD	CLASSES:Sorcerer,Wizard=9	
Wood Shape.MOD	CLASSES:Druid=2	
Word of Chaos.MOD	CLASSES:Cleric=7	DOMAINS:Chaos=7	
Word of Recall.MOD	CLASSES:Cleric=6|Druid=8	
Zone of Silence.MOD	CLASSES:Bard=4	
Zone of Truth.MOD	CLASSES:Cleric,Paladin=2	


